R 640 480
NO ./texture/colorstone.XPM
SO ./texture/wood.XPM
WE ./texture/greystone.XPM
EA ./texture/mossy.XPM

S ./texture/barrel.XPM
F 50,50,90
C 300, 330, 300

11111
100011
100011111
11000001111
1001110001
100000011
100110011111111111
100000000000000001
111111111111000001111
111011111111000S00001
111111111110000001001
111000000000000111101
111001111111110111101
111001111111110111101
111001111111110111101
111001111111110111101
111000000000000000001
11111111111111111111
